%%%%%%%%%%%%%%%%%%%%%%
%                    %
%      B             %
%          $$$$$$    %
% $$$$$$$            %
%                    %
%   $$$$$$$$$   B    %
%                    %
%           $$$$$$$  %
%       B            %
%%%%%%%%%%%%%%%%%%%%%%
