%%%%%%%%%%%%%%%%%%%%%%
%           E     $  %
%      B          $  %
%                 $  %
%                 $  %
%                 $  %
%                    %
%                    %
%    E      $$$$$$$  %
%                    %
%%%%%%%%%%%%%%%%%%%%%%
