%%%%%%%%%%%%%%%%%%%%%%
%           V     $  %
%      B          $  %
%          $$$$$$ $  %
% $$$$$$$         $  %
%                 $  %
%   $$$$$$$$$        %
%                    %
%    V      $$$$$$$  %
%                    %
%%%%%%%%%%%%%%%%%%%%%%
