%%%%%%%%%%%%%%%%%%%%%%
%                    %
%      B             %
%                    %
%                    %
%                    %
%         B          %
%             B      %
%                    %
%                    %
%%%%%%%%%%%%%%%%%%%%%%
