%%%%%%%%%%%%%%%%%%%%%%
%   %    %     %     %
%  %B%               %
%   %                %
%      $$$%%%%%%%$$  %
%  %$$$$$%    B %$$$ %
%  $$$   %%%%%%%%    %
%$$%    $%     %$$   %
%  $$$$   %$$$$$     %
%%%%%%%%%%%%%%%%%%%%%%
