%%%%%%%%%%%%%%%%%%%%%%
%   $    %     %     %
%  $ $               %
%   $                %
%      $$$%%%%%%%$$  %
%  %$$$$$%$ B B %$$$$%
%  $$$   %%%%%%%%    %
%$$%   E$%     %$$   %
%  $$$$   %$$$$$   B %
%%%%%%%%%%%%%%%%%%%%%%
