%%%%%%%%%%%%%%%%%%%%%%
%   $    %     %     %
%  $ $               %
%   $                %
%      $$$%%%%%%%$$  %
%  %$$$$$%$ E B %$$$$%
%  $$$   %%%%%%%%    %
%$$%    $%     %$$   %
%  $$$$   %$$$$$     %
%%%%%%%%%%%%%%%%%%%%%%
