%%%%%%%%%%%%%%%%%%%%%%
%   $    %     %   E %
%  $B$      E        %
%   $   B        E   %
% E    $$$$$  $$$$$  %
%  %$$$$$%$  B %$$$$$%
%  $$$   $$$$%$$$    %
%$$%   E$%     %$$   %
%  $$$$   %$$$$$     %
%%%%%%%%%%%%%%%%%%%%%%