%%%%%%%%%%%%%%%%%%%%%%%%%
% B % $$%$$$% $$% $$%   %
%$$$ $$ $$$$$$$$$ $ $$$$%
% $ %$$$%$$$%$$$%$$$% $ %
%$$$ $$ $$$$$$$$$ $ $$$$%
%$$ % $$%$$$% $$% $$%$$$%
%$$$ $$ $$$$$$$$$ $ $$$$%
% $$%$$$%$$$%$$$%$$$% $ %
%$$$ $$ $$$$$$$$$ $ $$$$%
%$$ % $$%$$$% $$% $$%$$$%
%$$$ $$ $$$$$$$$$ $ $$$$%
% $ %$$$%$$$%$$$%$$$%$$ %
%$$$ $$ $$$$$$$$$ $ $$$$%
%$$ % $$%$$$% $$% $$%$$$%
%$$$ $$ $$$$$$$$$ $ $$$$%
%   %$$$%$$$%$$$%$$$%B  %
%%%%%%%%%%%%%%%%%%%%%%%%%