%%%%%%%%%%%%%%%
% B %$$$$$% B %
%$$$%$$$$$%$$$%
%$$$$$$$$$$$$$%
%%$ $$%$%$$ $%%
%$$$%$$$$$%$$$%
%$$$$$$$$$$$$$%
%%$ $$%$%$$ $%%
%%$ $$%$%$$ $%%
%$$$$$$$$$$$$$%
%$$$%$$$$$%$$$%
%%$ $$%$%$$ $%%
%$$$$$$$$$$$$$%
%$$$%$$$$$%$$$%
% B %$$$$$% B %
%%%%%%%%%%%%%%%
