%%%%%%%%%%%%%%%%%%%%%%%%%
% B % $$%$$$% $$% $$% B %
%$$$ $$ $$$$$$$$$ $ $$$$%
% $ %$$$%$$$%$$$%$$$% $ %
%$$$ $$ $$$$$$$$$ $ $$$$%
%$$ % $$%$$$% $$% $$%$$$%
%$$$ $$ $$$$$$$$$ $ $$$$%
% $$%$$$%$   $$$%$$$% $ %
%$$$  $$      $$  $ $$$$%
%$$ % $$%  T  $$% $$%$$$%
%$$$ $$ $$% %$$$$ $ $$$$%
% $ %$$$%$$$%$$$%$$$%$$ %
%$$$ $$ $$$$$$$$$ $ $$$$%
%$$ % $$%$$$% $$% $$%$$$%
%$$$ $$ $$$$$$$$$ $ $$$$%
% B %$$$%$$$%$$$%$$$% B %
%%%%%%%%%%%%%%%%%%%%%%%%%