%%%%%%%%%%%%%%%%%%%%%%
%B                $E %
%                 $  %
%          $$$$$$$$  %
%$$$$$$$$         $  %
%                 $  %
%   $$$$$$$$$   E    %
%  E                 %
%           $$$$$$$  %
%   $$$$$$$$$ E      %
%%%%%%%%%%%%%%%%%%%%%%
