%%%%%%%%%%%%%%%%%%%%%%
%                 $  %
%      B          $  %
%          $$$$$$ $  %
% $$$$$$$         $  %
%                 $  %
%   $$$$$$$$$   E    %
%                    %
%           $$$$$$$  %
%                    %
%%%%%%%%%%%%%%%%%%%%%%
