%%%%%%%%%%%%%%%%%%%%%%
%B                   %
%                 $  %
%          $$$$$$$$  %
%$$$$$$$$         $R %
%                 $  %
%   $$$$$$$$$        %
%                    %
%           $$$$$$$  %
%   $$$$$$$$$        %
%%%%%%%%%%%%%%%%%%%%%%
