%%%%%%%%%%%%%%%%%%%%%%%
%$$ $$ $$ $$$ $$ $$ $$%
%      $       $      %
%$$$$$$R       R$$$$$$%
%                     %
% $  $     T     $  $ %
%      $       $      %
%$$$$$$         $$$$$$%
%  V   $$$$$$$$$  V   %
% $ $ $         $ $ $ %
%  R     $ $ $    R   %
%$$$$$$         $$$$$$%
%          $         B%
%%%%%%%%%%%%%%%%%%%%%%%
