%%%%%%%%%%%%%%%%%%%%%%
%                 $  %
%      B          $  %
%          $$        %
% $$$$$$$         $  %
%                 $  %
%   $$$$$$$$$   E    %
%                    %
%                    %
%                    %
%%%%%%%%%%%%%%%%%%%%%%
