%%%%%%%%%%%%%%%%%%%%%%
%                  %E%
% V  $$              %
%          $$        %
% $         $  %     %
%                 $  %
%   $   E   $        %
%                    %
%$$$$$$$    $$$$$$$$$%
%                   B%
%%%%%%%%%%%%%%%%%%%%%%
