%%%%%%%%%%%%%%%%%%%%%%
%   E     E       $E %
%    $$       E    $ %
%          $$        %
% $   EEE   $  %     %
%     EEE         $  %
%   $       $   E    %
%        E           %
%$$$$$$$    $$$$$$$$$%
%                   B%
%%%%%%%%%%%%%%%%%%%%%%
