%%%%%%%%%%%%%%%%%%%%%%
%E                $  %
%          $$$$$$$$  %
%                 $  %
%     $    $         %
%     $      E    $  %
%     $              %
%   $$$              %
%           $$$$$$$  %
%B    $              %
%%%%%%%%%%%%%%%%%%%%%%
