%%%%%%%%%%%%%%%%%%%%%%
%B                 E %
%                 $  %
%          $$$$$$$$  %
%$$$$$$$$         $  %
%                 $V %
%   $$$$$$$$$        %
%                    %
%           $$$$$$$  %
%   $$$$$$$$$        %
%%%%%%%%%%%%%%%%%%%%%%
