%%%%%%%%%%%%%%%%%%%%%%
%                  %E%
%    $$              %
%          $$        %
% $         $  %     %
%                 $  %
%   $       $        %
%        E           %
%$$$$$$$    $$$$$$$$$%
%                   B%
%%%%%%%%%%%%%%%%%%%%%%
