%%%%%%%%%%%%%%%
%     $B$     %
%      $      %
%      $$$    %
%        $    %
%        $    %
%             %
% R         %R%
%%%%%%%%%%%%%%%