%%%%%%%%%%%%%%%
%      B      %
%             %
%      $      %
%      $$$    %
%        $    %
%        $    %
%            %%
% R         %R%
%%%%%%%%%%%%%%%