%%%%%%%%%%%%%%%
%      B      %
%             %
%      $      %
%      $$$    %
%        $    %
%        $    %
%      $$$    %
%      E      %
%%%%%%%%%%%%%%%