%%%%%%%%%%%%%%%
%      B      %
%     $ $     %
%             %
%      $$$    %
%        $    %
%        $    %
%             %
%      E      %
%%%%%%%%%%%%%%%