%%%%%%%%%%%%%%%
%     $B$     %
%             %
%      $      %
%      $$$    %
%        $    %
%        $    %
%             %
%           %R%
%%%%%%%%%%%%%%%