%%%%%%%%%%%%%%%
%     $B$     %
%$    $ $     %
%  R   $      %
%      $$$    %
%        $    %
%        $    %
%             %
%             %
%%%%%%%%%%%%%%%