%%%%%%%%%%%%%%%
%     $B$     %
%             %
%  E   $      %
%      $$$    %
%        $    %
%        $    %
%             %
%             %
%%%%%%%%%%%%%%%