%%%%%%%%%%%%%%%
%     $B$     %
%     $ $     %
%     $ $$$$$ %
%     $     $ %
%     $$$$$ $ %
%         $ $ %
%        $$ $ %
%        $B $ %
%%%%%%%%%%%%%%%