%%%%%%%%%%%%%%%
%             %
%             %
%      $   B  %
%      $$$    %
%        $    %
%        $    %
%  E          %
%           % %
%%%%%%%%%%%%%%%