%%%%%%%%%%%%%%%
%     $B$     %
%            R%
%      $      %
%      $$$    %
%        $    %
%        $    %
%             %
% B           %
%%%%%%%%%%%%%%%