%%%%%%%%%%%%%%%%%%%%%%
%B                   %
%                    %
%                B   %
%                    %
%                    %
%                    %
%                   $%
%                  $ %
%%%%%%%%%%%%%%%%%%%%%%
