%%%%%%%%%%%%%%%%%%%%%%
%B $     %     %     %
% %                  %
%$                   %
%      $$$$$  $$$$$  %
%  %$$$$$%$    %$$$$$%
%  $$$   $$$$%$$$    %
%$$%    $%     %$$  %%
%  $$$$    $$$$$    E%
%%%%%%%%%%%%%%%%%%%%%%
