%%%%%%%%%%%%%%%%%%%%%%
%                   B%
%                    %
%                    %
%                    %
%                    %
%                    %
%                    %
%B                   %
%%%%%%%%%%%%%%%%%%%%%%
