%%%%%%%%%%%%%%%%%%%%%%
%                    %
%                    %
%                    %
%                    %
%    R     T         %
%                    %
%                    %
%                   B%
%%%%%%%%%%%%%%%%%%%%%%
