%%%%%%%%%%%%%%%%%%%%%%
%B                   %
%                    %
%                    %
%                    %
%                    %
%                    %
%                    %
%                   B%
%%%%%%%%%%%%%%%%%%%%%%
