%%%%%%%%%%%%%%%%%%%%%%
%                   B%
%                    %
%                    %
%         % %        %
%          T         %
%         % %        %
%                    %
%B                  B%
%%%%%%%%%%%%%%%%%%%%%%
