%%%%%%%%%%%%%%%%%%%%%%
%                   B%
%                    %
%                    %
%                    %
%                    %
%                    %
%                    %
%B                  B%
%%%%%%%%%%%%%%%%%%%%%%
