%%%%%%%%%%%%%%%%%%%%%%
%B                  B%
%                    %
%                    %
%                    %
%                    %
%                    %
%                    %
%                    %
%B                  B%
%%%%%%%%%%%%%%%%%%%%%%
