%%%%%%%%%%%%%%%%%%%%%%%%%
% B % $$%$$$% $$% $$% B %
%$$$ $$ $$$$$$$$$ $ $$$$%
% $ %$$$%$$$%$$$%$$$% $ %
%$$$ $$ $$$$$$$$$ $ $$$$%
%$$ % $$%$$$% $$% $$%$$$%
%$$$ $$ $$$$$$$$$ $ $$$$%
% $$%$$$%$$$%$$$%$$$% $ %
%$$$ $$ $$$$$$$$$ $ $$$$%
%$$ % $$%$$$% $$% $$%$$$%
%$$$ $$ $$$$$$$$$ $ $$$$%
% $ %$$$%$$$%$$$%$$$%$$ %
%$$$ $$ $$$$$$$$$ $ $$$$%
%$$ % $$%$$$% $$% $$%$$$%
%$$$ $$ $$$$$$$$$ $ $$$$%
% B %$$$%$$$%$$$%$$$% B %
%%%%%%%%%%%%%%%%%%%%%%%%%