%%%%%%%%%%%%%%%%%%%%%%%%%%%%%%%%%%
%    %     $$$$       E$$$$$$$   %
%  B     %     $$$$$$     %%%    %
%  E %$$$ $$$$%     %         %%$%
%$  $$$$$     %   $$$$$   B      %
%    %$$$$$   $$$$$   $  %    $ $%
%   $$$$%$$$   B   % E E E $     %
% E$%     %$$  %%%         %%$$$$%
%$   %$$$$$   B    $$$$$         %
% $$$$$  $$$$$     %   $$$$$   B %
%$$$%$    %$$$$$   $$$$$   $  %  %
%   $$$$%$$$   B   % E E E $     %
% E$%     %$$  %%%         %%$$$$%
%$   %$$$$$        $$$$$         %
%%%%%%%%%%%%%%%%%%%%%%%%%%%%%%%%%%