%%%%%%%%%%%%%%%%%%%%%%
%  %     %     %     %
%  %           %     %
%  %     %  %%%%%%%%%%
%  B%    %     %   %B%
%  %     %   %%%     %
%  %      %    %     %
%     %%%%      %%%% %
%  %     %           %
%%%%%%%%%%%%%%%%%%%%%%
