%%%%%%%%%%%%%%%%%%%%%%
%  %                 %
%  %                 %
%  %                %%
%  B%              %B%
%  %                %%
%  %                 %
%                    %
%  %                 %
%%%%%%%%%%%%%%%%%%%%%%
