%%%%%%%%%%%%%%%%%%%%%%
%B $     %     %     %
% %                  %
%$                   %
%      $$$$$  $$$$$  %
%  %$$$$$%$    %$$$$$%
%  $$$   $$$$%$$$    %
%$$%    $%     %$$  %%
%  $$$$    $$$$$    B%
%%%%%%%%%%%%%%%%%%%%%%
